{
    "width" : 24,
    "depth" : 24,

    "sunlight" : [ -1, 1, 0 ],

    "altitude": [
        0,0,0,0,0,0,0,0,0,0,0,0,0,0,0,0,0,0,0,0,0,0,0,0,
        0,1,1,1,1,1,1,1,1,1,1,1,1,1,1,1,1,1,1,1,1,1,1,0,
        0,1,2,2,2,2,2,2,2,2,2,2,2,2,2,2,2,2,2,2,2,2,1,0,
        0,1,2,3,3,3,3,3,3,3,3,3,3,3,3,3,3,3,3,3,3,2,1,0,
        0,1,2,3,4,4,4,4,4,4,4,4,4,4,4,4,4,4,4,4,3,2,1,0,
        0,1,2,3,4,5,5,5,5,5,5,5,5,5,5,5,5,5,5,4,3,2,1,0,
        0,1,2,3,4,5,6,6,6,6,6,6,6,6,6,6,6,6,5,4,3,2,1,0,
        0,1,2,3,4,5,6,7,7,7,7,7,7,7,7,7,7,6,5,4,3,2,1,0,
        0,1,2,3,4,5,6,7,8,8,8,8,8,8,8,8,7,6,5,4,3,2,1,0,
        0,1,2,3,4,5,6,7,8,9,9,9,9,9,9,8,7,6,5,4,3,2,1,0,
        0,1,2,3,4,5,6,7,8,9,10,10,10,10,9,8,7,6,5,4,3,2,1,0,
        0,1,2,3,4,5,6,7,8,9,10,11,11,10,9,8,7,6,5,4,3,2,1,0,
        0,1,2,3,4,5,6,7,8,9,10,11,11,10,9,8,7,6,5,4,3,2,1,0,
        0,1,2,3,4,5,6,7,8,9,10,10,10,10,9,8,7,6,5,4,3,2,1,0,
        0,1,2,3,4,5,6,7,8,9,9,9,9,9,9,8,7,6,5,4,3,2,1,0,
        0,1,2,3,4,5,6,7,8,8,8,8,8,8,8,8,7,6,5,4,3,2,1,0,
        0,1,2,3,4,5,6,7,7,7,7,7,7,7,7,7,7,6,5,4,3,2,1,0,
        0,1,2,3,4,5,6,6,6,6,6,6,6,6,6,6,6,6,5,4,3,2,1,0,
        0,1,2,3,4,5,5,5,5,5,5,5,5,5,5,5,5,5,5,4,3,2,1,0,
        0,1,2,3,4,4,4,4,4,4,4,4,4,4,4,4,4,4,4,4,3,2,1,0,
        0,1,2,3,3,3,3,3,3,3,3,3,3,3,3,3,3,3,3,3,3,2,1,0,
        0,1,2,2,2,2,2,2,2,2,2,2,2,2,2,2,2,2,2,2,2,2,1,0,
        0,1,1,1,1,1,1,1,1,1,1,1,1,1,1,1,1,1,1,1,1,1,1,0,
        0,0,0,0,0,0,0,0,0,0,0,0,0,0,0,0,0,0,0,0,0,0,0,0,
    ],

    "trees" : [
        {
            "x" : 1.5,
            "z" : 1.5
        },
        {
            "x" : 4.5,
            "z" : 4.5
        }
    ],

    "roads" : [
        {
            "width" : 3,
            "spine" : [
                1.5, 3,
                1.5, 0.5,
                7.5, 1.5,
                7.5, 1.5
            ]
        }
    ]
}


